1111111111
1P00000001
1000000001
1000000001
1000000001
1000000001
100C000001
1000000001
1000000E01
100C001C01
1111111111